21 21 21 21 21 21 21 21 21 21 21 21 21 21 21 21 21 21 21 21 21 21 21 21 21 21 21 21 21 21 21 21 21 21 21 21 21 21 21 21 21 21 21 21 21 21 21 21 21 21 
21 21 21 21 21 21 21 21 21 21 21 21 21 21 21 21 21 21 21 21 21 21 21 21 21 21 21 21 21 21 21 21 21 21 21 21 21 21 21 21 21 21 21 21 21 21 21 21 21 21 
21 21 21 21 21 21 21 21 21 21 21 21 21 21 21 21 21 21 21 21 21 21 21 21 21 21 21 21 21 21 21 21 21 21 21 21 21 21 21 21 21 21 21 21 21 21 21 21 21 21 
21 21 21 21 21 21 21 21 21 21 21 21 21 21 21 21 21 21 21 21 21 21 21 21 21 21 21 21 21 21 21 21 21 21 21 21 21 21 21 21 21 21 21 21 21 21 21 21 21 21 
21 21 21 21 31 29 29 29 29 29 29 29 29 29 29 29 29 29 29 29 29 29 29 29 29 29 29 29 29 29 29 29 29 29 29 29 29 29 29 29 29 29 29 29 32 21 21 21 21 21 
21 21 21 21 27 0 0 0 0 19 19 19 19 19 19 19 19 19 19 19 19 19 19 19 19 19 19 19 19 19 19 19 19 19 19 19 19 19 19 19 19 19 19 19 26 21 21 21 21 21 
21 21 21 21 27 0 0 0 0 19 19 2 19 19 2 19 2 19 2 2 19 19 2 19 2 19 19 19 2 2 2 2 19 2 19 2 19 19 2 19 19 19 19 19 26 21 21 21 21 21 
21 21 21 21 27 0 0 0 0 19 19 19 19 2 2 19 19 2 2 19 19 19 19 19 19 19 2 2 2 2 19 2 19 19 19 19 19 19 19 2 2 19 19 19 26 21 21 21 21 21 
21 21 21 21 27 0 0 0 0 19 19 19 19 19 19 19 19 19 19 19 19 19 19 2 19 19 2 19 2 2 19 2 2 2 19 19 2 2 2 2 2 2 19 19 26 21 21 21 21 21 
21 21 21 21 27 19 5 5 5 5 5 5 5 5 5 5 5 5 5 5 5 19 2 19 19 19 2 2 19 19 19 2 2 2 2 2 19 19 2 19 19 2 19 19 26 21 21 21 21 21 
21 21 21 21 27 19 5 5 4 4 4 4 4 4 4 4 4 4 5 5 5 19 19 19 19 19 19 2 2 19 2 19 2 19 2 19 19 19 19 19 2 2 2 19 26 21 21 21 21 21 
21 21 21 21 27 19 5 5 5 5 5 5 5 5 5 5 5 5 5 5 5 19 19 2 19 19 19 19 2 19 19 19 19 19 2 19 19 19 19 2 2 19 19 19 26 21 21 21 21 21 
21 21 21 21 27 19 5 5 4 4 4 4 4 4 4 4 4 4 5 5 5 2 2 2 2 19 19 19 2 19 19 19 19 19 2 19 19 2 19 2 2 2 19 19 26 21 21 21 21 21 
21 21 21 21 27 19 5 5 4 4 4 4 4 4 4 4 4 4 5 5 5 2 2 2 2 19 19 2 2 2 2 19 19 19 2 19 19 19 2 19 19 2 2 19 26 21 21 21 21 21 
21 21 21 21 27 19 5 5 5 5 5 5 5 5 5 5 5 5 5 5 5 19 19 19 2 2 19 2 2 19 2 2 19 2 2 2 19 19 19 19 2 2 19 19 26 21 21 21 21 21 
21 21 21 21 27 19 5 5 4 4 4 4 4 4 4 4 4 4 5 5 5 19 19 2 2 2 2 2 2 19 19 2 2 2 2 19 19 19 19 2 2 19 19 19 26 21 21 21 21 21 
21 21 21 21 27 19 5 5 5 5 5 5 5 5 5 5 5 5 5 5 5 19 19 19 19 2 19 19 19 19 19 19 19 19 19 19 19 2 2 2 2 19 19 19 26 21 21 21 21 21 
21 21 21 21 27 19 19 19 19 19 19 19 19 19 19 19 19 19 19 19 19 19 19 19 19 19 19 19 19 2 19 19 19 2 19 19 2 19 2 2 2 2 2 19 26 21 21 21 21 21 
21 21 21 21 27 19 19 2 19 19 2 19 2 19 19 19 2 19 19 19 2 19 19 2 19 19 2 19 19 19 19 2 19 19 19 2 2 19 2 2 19 19 19 19 26 21 21 21 21 21 
21 21 21 21 27 2 2 2 2 2 2 2 2 2 2 2 2 2 2 2 2 2 2 2 2 2 2 2 2 2 2 2 2 2 2 2 2 2 2 2 2 2 2 2 26 21 21 21 21 21 
21 21 21 21 27 2 2 19 2 2 2 2 2 2 2 2 2 2 2 2 2 2 2 2 2 2 2 2 2 2 2 2 2 2 2 2 2 2 2 2 2 2 2 2 26 21 21 21 21 21 
21 21 21 21 27 2 2 2 2 2 2 2 2 2 2 2 2 2 2 19 2 2 2 2 2 2 2 2 2 2 19 2 2 2 2 5 5 5 2 2 2 2 2 2 26 21 21 21 21 21 
21 21 21 21 27 2 2 2 2 2 2 19 2 2 2 19 2 2 2 2 2 2 2 2 2 2 2 2 2 2 2 2 2 2 5 5 5 5 5 2 2 19 2 2 26 21 21 21 21 21 
21 21 21 21 27 2 2 2 2 2 2 2 2 2 2 2 2 2 2 2 2 2 19 2 2 2 19 2 2 2 2 2 2 5 5 5 0 5 5 5 2 2 2 2 26 21 21 21 21 21 
21 21 21 21 27 2 19 2 2 2 2 2 2 2 2 2 2 19 2 19 2 2 2 2 2 2 2 2 2 2 2 2 2 5 5 0 0 0 5 5 2 2 2 2 26 21 21 21 21 21 
21 21 21 21 27 2 2 2 2 19 2 2 2 23 24 24 24 24 24 24 24 25 2 2 2 2 2 2 2 2 2 2 2 5 5 0 5 5 5 5 2 2 2 2 26 21 21 21 21 21 
21 21 21 21 27 2 2 2 2 2 2 23 24 34 21 21 21 21 21 21 21 33 24 25 2 2 2 19 2 2 2 2 2 5 5 0 0 0 5 5 2 2 19 2 26 21 21 21 21 21 
21 21 21 21 27 2 2 2 2 2 23 34 21 21 22 21 21 21 22 21 21 21 22 33 25 2 2 2 2 2 2 2 2 5 5 5 5 0 5 5 2 2 2 2 26 21 21 21 21 21 
21 21 21 21 27 2 2 2 2 2 26 21 21 21 21 21 21 21 21 21 21 21 21 31 30 2 2 2 2 2 2 2 2 5 5 0 0 0 5 5 2 2 2 2 26 21 21 21 21 21 
21 21 21 21 27 2 2 2 19 2 28 32 22 21 21 21 22 21 21 21 22 21 21 27 2 2 2 2 2 2 2 2 2 5 5 5 0 5 5 5 2 2 2 2 26 21 21 21 21 21 
21 21 21 21 27 2 2 2 2 2 2 28 29 32 21 21 21 21 21 31 29 29 30 2 19 2 2 2 19 2 2 2 2 2 5 5 5 5 5 2 2 2 2 2 26 21 21 21 21 21 
21 21 21 21 27 2 2 2 2 2 2 2 19 28 29 29 29 29 29 30 2 2 2 2 2 2 2 2 2 2 2 2 2 2 2 5 5 5 2 2 2 19 2 2 26 21 21 21 21 21 
21 21 21 21 27 2 2 2 2 2 2 2 2 2 2 2 19 2 2 2 2 2 2 2 2 2 2 2 2 2 2 2 2 2 2 2 2 2 2 2 2 2 2 2 26 21 21 21 21 21 
21 21 21 21 27 2 2 19 2 2 2 2 2 2 2 2 2 2 2 19 2 2 2 2 2 2 2 2 2 2 2 19 2 2 2 2 2 2 2 19 2 2 2 2 26 21 21 21 21 21 
21 21 21 21 27 2 2 2 2 2 2 2 19 2 2 2 2 2 2 2 2 2 2 2 2 2 19 2 2 2 2 2 2 2 2 19 2 2 2 2 2 2 19 2 26 21 21 21 21 21 
21 21 21 21 27 2 2 2 2 2 2 2 2 2 2 2 2 2 2 2 2 2 2 2 2 2 2 2 2 2 2 2 2 2 2 2 2 2 2 2 2 2 2 2 26 21 21 21 21 21 
21 21 21 21 27 19 19 19 2 19 19 19 19 19 19 19 19 19 19 19 19 19 19 19 19 19 19 19 19 19 19 19 19 19 23 24 24 24 24 24 24 24 24 24 34 21 21 21 21 21 
21 21 21 21 27 19 19 19 2 19 2 2 2 2 2 2 2 2 2 19 19 19 19 19 19 19 19 19 19 19 19 19 19 19 26 21 21 31 29 29 29 29 29 29 32 21 21 21 21 21 
21 21 21 21 27 19 19 19 2 20 20 20 20 20 20 20 20 2 2 19 19 19 19 19 19 19 19 19 19 19 19 19 19 19 26 21 21 27 2 2 2 2 2 2 26 21 21 21 21 21 
21 21 21 21 27 19 19 19 2 20 2 2 2 2 2 2 20 2 2 19 19 19 19 19 19 19 19 19 19 19 19 19 19 19 26 21 21 27 2 20 20 20 20 2 26 21 21 21 21 21 
21 21 21 21 27 19 19 19 2 5 5 5 5 5 18 2 2 2 2 2 2 2 2 2 2 2 2 2 2 2 2 2 1 1 1 1 1 1 1 20 5 5 20 2 26 21 21 21 21 21 
21 21 21 21 27 19 19 19 2 20 2 2 2 2 2 2 20 2 2 2 2 2 2 2 2 2 2 2 2 2 2 2 1 1 1 1 1 1 1 5 5 5 20 2 26 21 21 21 21 21 
21 21 21 21 27 19 19 19 19 20 20 20 20 20 20 20 20 2 2 2 2 2 2 2 2 2 2 2 2 2 2 2 1 1 1 1 1 1 1 20 5 5 20 2 26 21 21 21 21 21 
21 21 21 21 27 19 19 19 2 2 2 2 2 2 2 2 2 2 2 19 19 19 19 19 19 19 19 19 19 19 19 19 19 19 26 21 21 27 2 20 20 20 20 2 26 21 21 21 21 21 
21 21 21 21 27 19 19 19 19 19 19 19 19 19 19 19 19 19 19 19 19 19 19 19 19 19 19 19 19 19 19 19 19 19 26 21 21 27 2 2 2 2 2 2 26 21 21 21 21 21 
21 21 21 21 33 24 24 24 24 24 24 24 24 24 24 24 24 24 24 24 24 24 24 24 24 24 24 24 24 24 24 24 24 24 34 21 21 33 24 24 24 24 24 24 34 21 21 21 21 21 
21 21 21 21 21 21 21 21 21 21 21 21 21 21 21 21 21 21 21 21 21 21 21 21 21 21 21 21 21 21 21 21 21 21 21 21 21 21 21 21 21 21 21 21 21 21 21 21 21 21 
21 21 21 21 21 21 21 21 21 21 21 21 21 21 21 21 21 21 21 21 21 21 21 21 21 21 21 21 21 21 21 21 21 21 21 21 21 21 21 21 21 21 21 21 21 21 21 21 21 21 
21 21 21 21 21 21 21 21 21 21 21 21 21 21 21 21 21 21 21 21 21 21 21 21 21 21 21 21 21 21 21 21 21 21 21 21 21 21 21 21 21 21 21 21 21 21 21 21 21 21 
21 21 21 21 21 21 21 21 21 21 21 21 21 21 21 21 21 21 21 21 21 21 21 21 21 21 21 21 21 21 21 21 21 21 21 21 21 21 21 21 21 21 21 21 21 21 21 21 21 21 
