12 12 12 12 12 12 12 12 12 12 12 12 12 12 12 12 12 12 12 12 12 12 12 12 12 12 12 13 12 12 12 12 12 12 12 12 13 12 12 12 12 13 12 12 12 12 12 12 12 12 12 12 12 12 12
12 12 12 12 12 12 12 12 12 12 12 13 12 12 12 12 12 12 12 12 12 12 12 12 12 12 12 12 12 12 12 12 12 12 12 12 12 12 13 12 12 12 12 12 12 12 12 12 12 13 12 12 12 12 12
12 12 12 12 12 13 12 12 13 12 12 12 12 12 13 12 13 12 12 12 13 12 12 13 12 13 12 12 12 13 12 12 13 12 12 12 12 12 13 12 12 13 13 12 12 12 13 12 12 12 12 12 12 12 12
12 12 12 12 12 12 12 12 12 12 13 12 12 12 12 12 12 13 12 12 12 13 13 12 12 12 12 12 12 12 13 12 12 12 12 12 13 12 12 12 12 12 12 12 13 12 12 12 12 12 12 12 12 12 12
12 12 12 12 12 12 12 22 20 20 20 20 20 20 20 20 20 20 20 20 20 20 20 20 20 20 20 20 20 20 20 20 20 20 20 20 20 20 20 20 20 20 20 20 20 20 20 23 12 13 12 13 12 12 12
12 12 12 12 13 12 12 18 41 41 41 41 41 41 41 41 41 41 41 41 41 41 41 41 41 41 41 41 41 41 41 41 41 41 41 41 41 41 41 41 41 41 41 41 41 41 41 17 13 12 12 12 12 12 12
12 12 12 12 12 12 12 18 41 41 41 41 41 41 10 41 41 10 41 10 41 10 10 41 41 10 41 10 41 41 41 10 10 11 10 41 10 41 10 41 41 10 41 41 41 41 41 17 12 12 12 12 12 12 12
12 12 12 12 12 12 13 18 41 41 43 43 41 41 41 41 11 10 41 41 10 11 41 41 41 41 41 41 41 10 10 11 10 41 10 41 41 41 41 41 41 41 11 10 41 41 41 17 12 12 12 12 12 12 12
12 12 12 12 12 12 12 18 41 41 43 43 41 41 41 41 41 41 41 41 41 41 41 41 41 10 41 41 41 10 10 41 41 10 11 10 10 11 10 11 10 10 10 10 41 41 17 12 12 12 13 12 12 12 12
12 12 12 12 13 12 12 18 41 42 26 26 42 42 42 42 42 42 42 42 42 42 42 42 41 10 41 41 41 11 10 10 41 41 10 10 10 11 10 41 41 10 41 11 11 41 41 17 12 13 12 13 12 12 12
12 12 12 12 12 12 12 18 41 42 26 26 26 26 26 26 26 26 26 26 26 26 26 26 41 41 10 41 41 41 41 11 41 41 41 41 11 10 41 41 41 41 10 11 41 41 41 17 12 12 12 12 12 12 12
12 12 12 12 12 12 12 18 41 42 26 26 26 26 26 26 26 26 26 26 26 26 26 26 10 11 10 10 41 41 41 10 41 41 41 41 10 10 41 41 10 41 11 10 10 41 41 17 12 12 12 12 12 12 12
12 12 12 12 12 12 13 18 41 42 26 26 42 42 42 42 42 42 42 42 42 42 26 26 11 11 11 10 41 41 10 10 10 10 41 10 11 10 41 41 41 41 41 10 10 10 41 17 12 12 12 12 12 12 12
12 12 12 12 12 12 12 18 41 42 26 26 42 42 42 42 42 42 42 42 42 42 26 26 10 10 11 10 41 41 10 10 10 10 41 41 10 10 41 41 41 10 41 41 11 10 41 17 12 12 13 12 12 12 12
12 12 12 12 12 12 12 18 41 42 26 26 26 26 26 26 26 26 26 26 26 26 26 26 41 41 41 11 10 10 11 10 41 10 10 41 10 11 10 41 41 41 41 10 10 41 41 17 13 12 12 12 12 12 12
12 12 12 12 13 13 12 18 41 42 26 26 26 26 26 26 26 26 26 26 26 26 26 26 41 41 11 10 10 11 10 10 41 41 10 10 11 10 41 41 41 41 10 11 41 41 41 17 12 12 12 12 12 12 12
12 12 12 12 12 12 12 18 41 42 42 42 42 42 42 42 42 42 42 42 42 42 42 26 41 41 41 41 10 41 41 41 41 41 41 41 41 41 41 41 10 10 11 10 41 41 41 17 12 12 13 12 12 12 12
12 12 12 12 13 13 12 18 41 41 41 41 41 41 41 41 41 41 41 41 41 41 41 41 41 41 41 41 41 41 41 41 10 41 41 41 10 41 41 10 41 10 10 10 10 10 41 17 12 12 12 12 12 12 12
12 12 12 12 12 12 12 18 41 41 10 41 41 10 41 10 41 41 41 10 41 41 41 10 41 41 10 41 41 10 41 41 41 41 10 41 41 41 10 10 41 10 11 41 41 41 41 17 13 12 12 12 12 12 12
12 12 12 12 12 13 12 18 10 10 10 10 10 10 10 10 10 10 11 10 10 10 10 11 10 10 10 10 10 10 10 10 10 10 10 10 10 10 10 10 11 10 10 10 10 11 10 17 12 12 12 13 12 12 12
12 12 12 12 12 12 12 18 10 10 41 10 10 10 11 10 10 10 10 10 10 10 10 10 10 11 10 11 10 10 11 10 10 10 10 10 10 11 10 10 10 10 11 10 10 10 10 17 12 12 12 12 12 12 12
12 12 12 12 12 12 13 18 10 10 10 10 11 10 10 10 10 10 10 10 11 10 41 10 10 10 10 10 11 10 10 10 10 41 10 10 10 10 26 26 26 10 10 10 10 10 10 17 13 12 12 12 12 12 12
12 12 12 12 13 12 12 18 10 11 10 10 10 10 41 10 10 10 41 10 10 10 10 11 10 10 10 10 10 10 10 10 10 10 10 11 10 26 26 26 26 26 10 10 41 10 11 17 12 12 12 12 12 12 12
12 12 12 12 12 13 12 18 10 10 10 10 10 10 10 11 10 10 10 10 10 10 10 10 10 41 10 10 10 41 10 11 10 11 10 10 26 26 26 43 26 26 26 10 10 10 10 17 12 12 12 12 12 12 12
12 12 12 12 12 12 12 18 10 41 10 11 10 10 10 10 10 10 11 10 41 10 41 10 10 10 10 10 11 10 10 10 10 10 10 10 26 26 43 43 43 26 26 10 11 10 10 17 12 12 13 13 12 12 12
12 12 12 12 12 12 12 18 10 10 10 10 41 10 10 10 14 15 15 15 15 15 15 15 16 10 10 10 10 10 10 10 11 10 10 11 26 26 43 26 26 26 26 10 10 10 10 17 12 12 12 12 12 12 12
12 12 12 12 12 12 12 18 10 10 10 10 10 10 14 15 25 12 12 13 12 12 12 12 24 15 16 10 10 10 41 10 10 10 11 10 26 26 43 43 43 26 26 10 10 41 10 17 12 13 12 12 12 12 12
12 12 12 12 12 13 12 18 10 10 10 11 10 14 25 13 12 13 12 12 12 13 13 12 12 13 24 16 10 10 10 10 10 10 11 10 26 26 26 26 43 26 26 10 10 10 10 17 12 13 12 13 12 12 12
12 12 12 12 12 12 12 18 11 10 10 10 10 17 12 12 12 12 12 12 12 12 12 12 12 12 22 21 10 10 11 10 10 11 10 10 26 26 43 43 43 26 26 10 11 10 10 17 12 12 12 12 12 12 12
12 12 12 12 13 12 12 18 10 10 10 41 10 19 23 13 12 12 12 13 12 12 12 13 12 22 21 10 10 10 10 10 10 10 10 10 26 26 26 43 26 26 26 10 10 11 10 17 12 12 12 12 12 12 12
12 12 12 12 12 12 12 18 10 11 10 10 10 10 19 20 23 12 13 12 12 13 22 20 20 21 10 41 10 10 10 41 10 11 10 10 10 26 26 26 26 26 10 10 10 10 10 17 12 12 13 12 12 12 12
12 12 12 12 12 12 13 18 10 10 10 10 10 10 10 41 19 20 20 20 20 20 21 10 10 10 10 10 10 10 10 10 10 10 10 11 10 10 26 26 26 10 10 11 41 10 10 17 12 12 12 12 12 12 12
12 12 12 12 12 12 12 18 10 11 10 10 11 11 10 11 10 10 10 41 10 10 10 10 11 10 11 10 11 10 10 10 10 10 10 10 10 10 10 11 10 11 10 10 10 10 10 17 12 13 12 12 12 12 12
12 12 12 12 12 13 12 18 11 10 41 10 10 10 10 10 10 10 11 10 10 10 41 10 10 10 10 10 10 10 10 10 11 10 41 10 10 11 10 10 10 10 41 10 10 10 10 17 12 13 12 12 12 12 12
12 12 12 12 13 12 12 18 10 11 10 10 11 10 10 41 10 11 10 10 10 10 11 10 10 11 10 11 10 41 10 10 10 10 10 10 10 10 41 10 10 10 10 10 11 41 10 17 12 12 12 12 12 12 12
12 12 12 12 12 12 12 18 10 10 10 10 10 10 10 10 10 10 10 11 10 10 10 10 10 10 10 10 10 10 10 10 10 10 11 10 10 10 10 10 10 11 10 10 10 10 10 17 12 12 12 13 12 12 12
12 12 12 12 12 13 12 18 41 41 41 26 41 41 41 41 41 41 41 41 41 41 41 41 41 41 41 41 41 41 41 41 41 41 41 41 41 14 15 15 15 15 15 15 15 15 15 25 12 13 12 12 12 12 12
12 12 12 12 12 12 12 18 41 41 41 26 41 41 41 41 41 41 41 41 41 41 41 41 41 41 41 41 41 41 41 41 41 41 41 41 41 17 13 12 22 20 20 20 20 20 20 23 12 12 12 12 12 12 12
12 12 12 13 12 12 12 18 41 41 41 26 40 40 40 40 40 40 40 40 41 41 41 41 41 41 41 41 41 41 41 41 41 41 41 41 41 17 12 13 18 10 10 10 10 10 10 17 12 12 13 12 12 12 12
12 12 12 12 12 12 12 18 41 41 41 26 40 43 43 43 43 43 43 40 41 41 41 41 41 41 41 41 41 41 41 41 41 41 41 41 41 17 12 12 18 10 40 40 40 40 10 17 12 12 12 12 12 12 12
12 12 12 12 12 12 12 18 41 41 41 26 40 43 43 43 43 43 43 40 41 41 41 41 41 41 41 41 41 41 41 41 41 41 41 41 41 17 12 12 18 10 40 40 40 40 10 17 12 12 12 12 12 12 12
12 12 12 12 12 13 13 18 41 41 41 26 43 43 43 43 43 39 43 43 10 10 10 10 10 10 10 10 10 10 10 10 10 10 10 44 44 44 44 44 44 44 40 26 26 40 10 17 12 12 12 12 12 12 12
12 12 12 12 12 12 12 18 41 41 41 41 40 43 43 43 43 43 43 40 10 10 11 10 10 10 10 10 10 10 10 10 10 10 10 44 44 44 44 44 44 44 26 26 26 40 10 17 13 12 12 12 12 12 12
12 12 12 12 12 12 12 18 41 41 41 41 40 40 40 40 40 40 40 40 10 10 10 10 10 10 10 10 10 10 10 10 10 10 10 44 44 44 44 44 44 44 40 26 26 40 10 17 12 12 13 12 12 12 12
12 12 12 12 13 12 12 18 41 41 41 41 41 41 41 41 41 41 41 41 41 41 41 41 41 41 41 41 41 41 41 41 41 41 41 41 41 17 12 12 18 10 40 40 40 40 10 17 12 12 12 13 12 12 12
12 12 12 12 12 12 12 18 41 41 41 41 41 41 41 41 41 41 41 41 41 41 41 41 41 41 41 41 41 41 41 41 41 41 41 41 41 17 13 12 18 10 10 10 10 10 10 17 12 12 12 12 12 12 12
12 12 12 12 13 13 12 24 15 15 15 15 15 15 15 15 15 15 15 15 15 15 15 15 15 15 15 15 15 15 15 15 15 15 15 15 15 25 12 12 24 15 15 15 15 15 15 25 13 12 12 12 12 12 12
12 12 12 12 12 12 12 12 13 12 12 12 12 12 12 12 12 12 12 12 12 12 12 12 12 12 12 12 13 12 12 12 12 12 12 12 12 12 13 12 12 12 13 12 12 12 12 12 12 12 12 12 12 12 12
12 12 12 12 12 12 13 12 12 13 12 12 13 12 12 12 12 13 12 12 13 12 12 12 13 12 12 12 12 12 12 12 12 13 12 12 12 12 12 12 12 12 12 12 12 13 12 13 12 13 12 12 12 12 12
12 12 12 12 12 12 12 12 12 12 12 12 12 12 12 12 12 12 12 12 13 12 12 12 12 12 13 12 12 12 13 12 12 12 12 13 12 13 12 12 13 12 12 12 12 12 12 12 12 12 12 12 12 12 12
12 12 12 12 12 12 12 12 12 12 12 12 12 13 12 12 12 12 12 12 12 12 12 12 12 12 12 12 12 12 12 12 12 12 12 12 12 12 12 12 12 12 12 12 12 12 12 12 12 12 12 12 12 12 12
12 12 12 12 12 12 12 12 12 12 12 12 12 12 12 12 12 12 12 12 12 12 12 12 12 12 12 13 12 12 12 12 12 12 12 12 13 12 12 12 12 13 12 12 12 12 12 12 12 12 12 12 12 12 12
12 12 12 12 12 12 12 12 12 12 12 13 12 12 12 12 12 12 12 12 12 12 12 12 12 12 12 12 12 12 12 12 12 12 12 12 12 12 13 12 12 12 12 12 12 12 12 12 12 13 12 12 12 12 12





